1111111111111111111111111
1111111111111111111111111
1111111111111111111111111
0000000000100001111111110
0000000000100000000000000
1111111100100001011111111
1111111100100001011111111
0000000000100001011111111
1100011100100001011111111
1100000000100001011111111
1100011100100001011111111
1100011000100001011111111
1100011000100001011111111
0000011000100001011111111
0000000000100001011111111
1100000000100001011111111
1100011100000001011111111
1100011100000001011111111
1100011100100001011111111
0000000000100001011111111

