1111111111111111111111111
1100100101140001000100101
0100100101100001000100101
0000000000000000000000000
0000000000100001000000000
0000000000100001000000000
0110110110100001001100110
1111111111100001111111111
1100100101100001000100101
0100100101100001111111101
0000000000000000000000000
0000000000100001000000000
0110110110100001001100110
1111111111100001111111111
1100100101100001111111111
0100100101100001111100111
0000000000000001000000000
0000000000100001000000000
0110110110100000000001110
1111111111111111111111111
1111111111111111111111111

