111111111111111111111111111
111111001103001100111111011
111111011100001110111111011
000000000100001000000000011
111111000100001000111111011
111111000100001000111111011
111111011100001000111111011
111111011100001111111111011
000000000000000000000000011
111111111100001111111111011
111111111100001111000000011
111111111100001111000000011
111111000100001000111111011
111111000100001000111111011
000000000100001000000000011
111111000100001000111111011
111111000100001000111111011
111111111144441111111111111
111111111111111111111111111
111111111111111111111111111
