111111111111111111111111111
111111111110101111111111111
011111100110001100000000011
011111101110001100110000011
000000000010001000111000011
011111100010001000101000011
011111100010000000000000011
011111100010001000000000011
011111111110001111111111111
000000000000000000110000011
111111111110000000111000011
000000001010001000000000011
000000111010001000000000011
111111000010001001111111111
111111000010001001111111111
000000000010001000000000011
111111000010001001111111111
111111000010001001111111111
111111000000001001111111111
111111111111111111111111111
111111111111111111111111111



