111111111111111111111111111
110010010112000100010010111
010010010110000100010010111
000000000000000000000000011
000000000010000100000000011
000000000010000100000000011
011011011010000100110011011
111111111110000111111111111
110010010110000100010010111
010010010110000111111110111
000000000000000000000000011
000000000010000100000000011
011011011010000100110011011
111111111110000111111111111
110010010110000111111111111
010010010110000111110011111
000000000000000100000000011
000000000010000100000000011
011011011010000000000111011
111111111111111111111111111
111111111111111111111111111

