111111111111111111111111111
111111111111121111111111111
111111111110000010000100011
000000000010000011111111011
111111110010000000000000011
111111110010000510110000011
000000000010000010110000011
110001110010000010110000111
110001110010000010110000111
000000000010000010111000111
000000000010000010111000111
110001100010000010111000111
110001100010000010111000011
000001100010000010000000011
000000000015000010111001111
110000000000000010111001111
110001100000000010111001111
110001100010000010111000011
111111111111111111111111111
111111111111111111111111111
